AIVA	EY V AH
ALL	AO L
CHROME	K R OW M
CLOSE	K L OW S
CLOSE(2)	K L OW Z
COMMAND	K AH M AE N D
DRIVE	D R AY V
EXIT	EH G Z IH T
EXIT(2)	EH K S AH T
EXPLORER	IH K S P L AO R ER
FILE	F AY L
FILES	F AY L Z
GO	G OW
GOOGLE	G UW G AH L
MAIL	M EY L
MY	M AY
NETFLIX	N EH T L AH K S
OPEN	OW P AH N
PROMPT	P R AA M P T
PULL	P UH L
TERMINAL	T ER M AH N AH L
THE	DH AH
THE(2)	DH IY
TO	T UW
TO(2)	T IH
TO(3)	T AH
UP	AH P
YOUTUBE	Y UW T UW B
